        
NO textures/north_1024.xpm
SO textures/south_1024.xpm
WE textures/west_1024.xpm
EA textures/east_1024.xpm

F 180,140,65
C 220,200,234

11111111111111111111111111
11110000000110000000000001
1011000001110000000000001
1001000000000000000000001
111111111011000001110000111111111
111000000011000001110111111111111
   11110111111111011100000010011
111101111111110111010100111111
11000000110101011100000010001
10000000000000001100000010001
10000000000000001101010010001
11000001110101011111011110E0111
11110111 1110101 101111010001
11111111 1111111 111111111111




