        
NO textures/north_1024.xpm
NO textures/north_1024.xpm


SO textures/south_1024.xpm
WE textures/west_1024.xpm

EA textures/east_1024.xpm

F 140,50,60
C 80,145,200

11111111111111111111111111
11110000000110000000000001
10110000011100000000000001
1001000000000000000000001
111111111011000001110000111111111
111000000011000001110111111111111
   11110111111110011100000010011
111101111111110100010100111111
11000000110101011100000010001
10000000000000000000000000001
10000000000000001101010010001
11000001110101011111011110E0111
11110111 1110101 101111010001
11111111 1111111 111111111111




